1111111111111
1P00000001111
10000C1111111
1111000000011
100C000000011
1C11101111011
1011111E11111
1011111011111
10C0000011111
1000001100011
1000000000011
1110011100011
1111111111111
